1111111111111
1110011000001
1111111110001
10001101CCCC1
100001011CEP1
1111110000C11
1100000011001
1011C00001101
100010C000101
1000011C00001
1000111011001
1000010C00101
1010000010CC1
1C11000111001
100000C000001
1000000000001
1000000000001
1111111011111
1000000000001
1C1CCCCCCCCC1
1111111111111
