111111
100001
1E0P01
1CC111
111111
