11111
1P1C1
10111
1E001
11111
