111111
10C001
1P0001
1E0001
111111
