1111111
10C0011
1P00011
1E00011
1111111
