111111
10C0011
1P0001
1E0001
111111
